WIWWWIIWWWIWWWW
WWWIWWWIWWWWWWW
WWIWWDWWWDWWIWW
WWWsssWIWsssWWW
WIWsssWWWsssWWI
WWWssWWWWWssWWW
IWWssssWssssWIW
WWWWsSsWsssWWWW
WWWWWsWWWsWIWWW
WWWIWsWWWsWWWIW
WIWWsssWsssWIWW
WWWWsCsWsCsWWWW
IWWWsssWsssWIWW
WWWIWWWIWWWWWIW
WWIWWWWWWIWWWWW