LWWWWWWWWWWWLWW
LWWWWWWWWWWWLLW
LLWDssssWWWDWLW
LLWWWWssWWWsWLL
LLWWWWssWWWsWLL
LLLWWWssWWWsWWL
LLLWWWssssssssW
LLLWWWssWWWsssW
LLLLWsCCssssssW
LLLLWsssSssWWWW
LLLLWWWWWWWWWWW
WLLLLLWWWWWWWWW
WWLLLLLLWWWWWWW
WWWLLLLLLLWWWWW
WWWWLLLLLLLLLLL