WIWWWIIWWWIWWWW
WWWIWWWIWWWWWWW
WWIWWCWWWDWWIWW
WWWssKWIWsssWWW
WIWsssWWWsssWWI
WWWssWsssWssWWW
IWWssssWssssWIW
WWWWsssWsssWWWW
WWWWWsWWWsWIWWW
WWWIWsWWWsWWWIW
WIWWsssWsssWIWW
WWWWsssWsCsWWWW
IWWWsssWsssWIWW
WWWIWWWIWWWWWIW
WWIWWWWWWIWWWWW